Room Wodplay or Surrealist project
An Interactive Fiction by Avita, Chris & Steph
Release 1 / Serial number 161016 / Inform 7 build 6M62 (I6/v6.33 lib 6/12N) SD

Room
You are in a room.

>help
Examine everything.

>[down]
Introduction to Room Wodplay
 > Instructions for Play
   Contacting the author
   Hints
   Settings

   Introduction to Room Wodplay
 > Instructions for Play
   Contacting the author
   Hints
   Settings

>[down]
Introduction to Room Wodplay
   Instructions for Play
 > Contacting the author
   Hints
   Settings

   Introduction to Room Wodplay
   Instructions for Play
 > Contacting the author
   Hints
   Settings

>[down]
Introduction to Room Wodplay
   Instructions for Play
   Contacting the author
 > Hints
   Settings

   Introduction to Room Wodplay
   Instructions for Play
   Contacting the author
 > Hints
   Settings

>[down]
Introduction to Room Wodplay
   Instructions for Play
   Contacting the author
   Hints
 > Settings

   Introduction to Room Wodplay
   Instructions for Play
   Contacting the author
   Hints
 > Settings

>[up]
Introduction to Room Wodplay
   Instructions for Play
   Contacting the author
 > Hints
   Settings

   Introduction to Room Wodplay
   Instructions for Play
   Contacting the author
 > Hints
   Settings

>[down]
Introduction to Room Wodplay
   Instructions for Play
   Contacting the author
   Hints
 > Settings

   Introduction to Room Wodplay
   Instructions for Play
   Contacting the author
   Hints
 > Settings

>[enter]
> Verbose room descriptions
   Score notification on

>[down]
Verbose room descriptions
 > Score notification on

   Verbose room descriptions
 > Score notification on

>[up]
> Verbose room descriptions
   Score notification on

 > Verbose room descriptions
   Score notification on

>p
> Verbose room descriptions
   Score notification on

 > Verbose room descriptions
   Score notification on

>p
> Verbose room descriptions
   Score notification on

 > Verbose room descriptions
   Score notification on

>P
> Verbose room descriptions
   Score notification on

 > Verbose room descriptions
   Score notification on

>[enter]
Room Wodplay is now in its "brief" printing mode, which gives long descriptions of places never before visited and short descriptions otherwise.

 > Brief room descriptions
   Score notification on

 > Brief room descriptions
   Score notification on

>[enter]
Room Wodplay is now in its "superbrief" mode, which always gives short descriptions of locations (even if you haven't been there before).

 > Superbrief room descriptions
   Score notification on

 > Superbrief room descriptions
   Score notification on

>[enter]
Room Wodplay is now in its "verbose" mode, which always gives long descriptions of locations (even if you've been there before).

 > Verbose room descriptions
   Score notification on

 > Verbose room descriptions
   Score notification on

>[up]
> Verbose room descriptions
   Score notification on

 > Verbose room descriptions
   Score notification on

>[up]
> Verbose room descriptions
   Score notification on

 > Verbose room descriptions
   Score notification on

>[down]
Verbose room descriptions
 > Score notification on

   Verbose room descriptions
 > Score notification on

>[down]
Verbose room descriptions
 > Score notification on

   Verbose room descriptions
 > Score notification on

>Q
Introduction to Room Wodplay
   Instructions for Play
   Contacting the author
   Hints
 > Settings

>[up]
Introduction to Room Wodplay
   Instructions for Play
   Contacting the author
 > Hints
   Settings

   Introduction to Room Wodplay
   Instructions for Play
   Contacting the author
 > Hints
   Settings

>[up]
Introduction to Room Wodplay
   Instructions for Play
 > Contacting the author
   Hints
   Settings

   Introduction to Room Wodplay
   Instructions for Play
 > Contacting the author
   Hints
   Settings

* * *

>help
Examine everything.

>HELP
You can Interact or Examine name of object

>HELP ME
You can Interact or Examine name of object

* * *

>help
Examine everything.

>look note
+--------------------------------------+
 | Look for painting; Uifsf jt bo boomf. | 
 |                                                                 | 
 | _ _ _ _ _ _ _ _ _ _ _ _ _ _ _ _ _ _ _ _ _ _ _ _ | 
 +--------------------------------------+

>look painting
A painting of Julius Caesar glares at you. He is crossing the Rubicon to Rome in the West.

>apple
That's not a verb I recognise.

>take apple
You pick up the apple.

>look note
+--------------------------------------+
 | Look for painting; Uifsf jt bo boomf. | 
 |  baiting PantS                                        | 
 | _ _ _ _ _ _ _ _ _ _ _ _ _ _ _ _ _ _ _ _ _ _ _ _ | 
 +--------------------------------------+

>look apple
There is a juicy red apple shaped as a heart next to a warped pot. You want to take the heart-shaped apple. You trust that there are no worms hidden inside it.

>put apple in pot
You crush the heart-apple in the pot. Smoke bellows outward, forming a shuddering tree. The wispy tree grows and grows until the air consumes it. You look into the pot, and a knife stares back at you.

>grab knife
That's not a verb I recognise.

>take knife
You pick up the knife.

>stab painting
(with the knife)
As you turn towards the painting, you hear a faint whisper,  Et tu, Brute?  You realize that what you thought was Caesar is actually a re-animated corpse crossing the river Styx. This strengthens your desire to wield the knife.

You stab the corpse over and over again until its shredded remains scatter on the floor. The frame breaks, dragging the crumbling leftovers down with it. You see a faded patch where the painting once was. Scribbled on the wall is: O6GOCEEE 28 31 in some reddish pigment.

You see a screen labeled B-Box displaying a keyboard next to the embedded scratches. The only keys present are the alphabet and the digits 0 - 9. The screen pulsates with "WAITING FOR INPUT" at the top.

The knife's blade breaks, and disappears among the scraps. The knife now has no purpose.

>i
You are carrying nothing.

>break pot
In the dusty, smoked-strewn room, amidst the broken pieces of a once intact thing, lies the pot's useless corpse. Was that really necessary?

>note
That's not a verb I recognise.

>look note
+--------------------------------------+
 | Look for painting; Uifsf jt bo boomf. | 
 |  baiting PantS                                        | 
 |  maKe dOor                                           | 
 +--------------------------------------+

>x note
+--------------------------------------+
 | Look for painting; Uifsf jt bo boomf. | 
 |  baiting PantS                                        | 
 |  maKe dOor                                           | 
 +--------------------------------------+

>make door
On the blank wall reveals an outline of a door. You press against it and feel it give, despite no hinge showing. You accept the existence of the door and go through, feeling yourself lifting upwards.

Room
As you enter the next room, you smell blood and taste the gnarling cacaphoney of a broken record. Splashes of dried blood cover the walls; everything in the room is sinking and stained. You see your hands. They are red to your wrists, and you can't remove it. You feel nausceous, and start hyperventilating. You struggle through dark spots and white flashes, eventually renouncing sight altogether. You trip on something squishy. You can't get up, and the squishyness is crawling up your leg. You wish you had your knife. You hate this. You hate this so much. You hate this enough to grab the thing and squeeze and squeeze until it cracks and you throw it against the bloody wall and walk over to it and stomp it to bits. You notice tiny globs emerging from the carcass and oozing towards you. You run back to the old door and open it, tears blotching your vision. 

Room
As you enter the next room, the air waftes with the sickening stench of gore, but you don't see any damage. The walls are bleached badly; you can still see the former jarring colors of dark oranges paired with limey greens and violets. The sticky carpet seems like it was once soft. You think that this room may have belonged to a child. You think that you've seen this room before...

You can see a stuffed bear, photograph and a sailboat here.

>look at bear
You see a dilapitated stuffed bear. As you inch closer to it, the bear's open maw snaps shut. Its hollow eyes follow you throughout the room.

Your hand is aching; the pain throbs with every step taken away from the bear. It slowly spreads to your chest as your rage builds. You punch the bear in the jar with your damaged fist---you hear your hand crunch, but can't feel it. You pummel it again and again until you can feel something. The bear is no more.

>x stuffed animal
You hate this bear.

>x photos
Your eyes catch the eyes of a woman in pink tones sharpely smiling. Your finger traces the curves of her face, circling around until you land on her head. You can now appreciate her temper, and wish you could start over with her again. But she does not deserve that, not any more. You methodically cut her in half.

>x photograph
Scattered shreds of a ruined photograph are stuck to the floor

>s
Room
As you enter the next room, you smell blood and taste the gnarling cacaphoney of a broken record. Splashes of dried blood cover the walls; everything in the room is sinking and stained.

You can see a stuffed bear, photographs and a sailboat here.

>x stuffed bear
You see a dead bear. Its red fluffiness is speckled with deep, brownish white scabs. Its hollow eyes follow you throughout the room
Your eyes are aching; the pain throbs with every step taken away from the bear. It slowly spreads down your face to your fists as your rage builds. You punch the bear in the jar with your damaged fist---you hear something break, but can't feel it. You pummel it again and again until you can feel something. The eyes are saved for last.  Crunch. Crunch. Crunch.  Tasty.

>x stuffed bear
You hate this bear.

>x sailboat
You see a sailboat and are reminded of your dreams of escaping this dreary world.

>x photographs
You can almost taste the sweetly baked loaf of bread that you used to have, captured in this photo. But that taste is no longer yours since you've forsaken the maker of the loaves. You needed a baseline of self respect that was always diminished in her sickly charming ways. But the bread has no part in her machinations, and is left alone.

>s
You can't go that way.

>w
You can't go that way.

>n
Room
As you enter the next room, you smell blood and taste the gnarling cacaphoney of a broken record. Splashes of dried blood cover the walls; everything in the room is sinking and stained.

You can see a stuffed bear, photographs and a sailboat here.

>e
Room
As you enter the next room, you smell blood and taste the gnarling cacaphoney of a broken record. Splashes of dried blood cover the walls; everything in the room is sinking and stained.

You can see a stuffed bear, photographs and a sailboat here.

>open door
You can't see any such thing.

>x
What do you want to examine?

>look
Room
As you enter the next room, you smell blood and taste the gnarling cacaphoney of a broken record. Splashes of dried blood cover the walls; everything in the room is sinking and stained.

You can see a stuffed bear, photographs and a sailboat here.

>x sailboat
You see a sailboat and are reminded of your dreams of escaping this dreary world.

>x stuffed bear
You see a dilapitated stuffed bear. As you inch closer to it, the bear's open maw snaps shut. Its hollow eyes follow you throughout the room.

Your hand is aching; the pain throbs with every step taken away from the bear. It slowly spreads to your chest as your rage builds. You punch the bear in the jar with your damaged fist---you hear the crunch, but can't feel it. You pummel it again and again until you can feel something. The bear is no more.

>x photograph
Your eyes catch the eyes of a woman in pink tones sharpely smiling. Your finger traces the curves of her face, circling around until you land on her head. You can now appreciate her temper, and wish you could start over with her again. But she does not deserve that, not any more. You methodically cut her in half.

>look
Room
As you enter the next room, you smell blood and taste the gnarling cacaphoney of a broken record. Splashes of dried blood cover the walls; everything in the room is sinking and stained.

You can see a stuffed bear, photographs and a sailboat here.

>look
Room
As you enter the next room, you smell blood and taste the gnarling cacaphoney of a broken record. Splashes of dried blood cover the walls; everything in the room is sinking and stained.

You can see a stuffed bear, photographs and a sailboat here.

>x stuffed bear
You hate this bear.

>n
You can't go that way.

>s
You can't go that way.

>w
Room
As you enter the next room, you smell blood and taste the gnarling cacaphoney of a broken record. Splashes of dried blood cover the walls; everything in the room is sinking and stained.

You can see a stuffed bear, photographs and a sailboat here.

>x bear
You can't see any such thing.

>x stuffed bear
You hate this bear.

>x sailboat
You see a sailboat and are reminded of your dreams of escaping this dreary world.

You uncovered a hidden switch and random door!

>go through door
You can't see any such thing.

>look door
You can't see any such thing.

>look random door
Inscribed on the door is randoor
You uncovered a hidden switch and random door!

>turn on switch
It isn't something you can switch.

You uncovered a hidden switch and random door!

>look switch
You flipped the switch on

>randdor
That's not a verb I recognise.

>randoor
Room
As you enter the next room, you smell blood and taste the gnarling cacaphoney of a broken record. Splashes of dried blood cover the walls; everything in the room is sinking and stained.

You can see a stuffed bear, photographs and a sailboat here.

>x bear
You can't see any such thing.

>x stuffed animal
You see a dead bear. As you inch closer to it, the bear's open maw snaps shut. Its hollow eyes pierce you.

You feel its stare boring a hole in your empty chest. You don't need this. Your hands, still wet, reach into the Bear and pull its insides out. The eyes are saved for last.  Crunch. Crunch. Crunch.  Tasty.

>x photographs
A swirl of movement cascades across the picture, like stop motioned captured on one still. You love and regret and understand and forgive and still feel anger against fate and the whims of forces you cannot control. The moving image stays silently on the wall, proud in its withering defiance.

>x sailboats
You can't see any such thing.

>x sailboat
You see a sailboat and are reminded of your dreams of escaping this dreary world.

You uncovered a hidden switch and random door!

>flip switch
That's not a verb I recognise.

>look switch
You flipped the switch on

* * *

>look
Room
As you enter the next room, you smell blood and taste the gnarling cacaphoney of a broken record. Splashes of dried blood cover the walls; everything in the room is sinking and stained.

You can see a stuffed bear, photographs and a sailboat here.

>x bear
You can't see any such thing.

>x stuffed beawr
You can't see any such thing.

>x stuffed bear
You hate this bear.

>x photographs
You can't bear to look away and you can't live with yourself staring at the photo on the wall.

>x sailboat
The sailboat sails away on the back of festering dreams

>x switch
You flipped the switch on

>x swithc
You can't see any such thing.

>x switch
You flipped the switch on

>x door
You can't see any such thing.

* * *

>x stuffed bear
You hate this bear.

>x photograph
You can't bear to look away and you can't live with yourself staring at the photo on the wall.

* * *

>x photograph
Scattered shreds of a ruined photograph are stuck to the floor

>x boat
You see a sailboat and reminisce on your dreams of escaping this dreary world.

You uncovered a hidden switch and random door!

>x bear
You hate this bear.

>x photo
Scattered shreds of a ruined photograph are stuck to the floor

>x boat
On closer examination, you notice that the sailboat has the scars of spending most of its life inside a bottle. You feel yourself rooting for the little boat.

>x switch
The switch is off

>switch swich
You can't see any such thing.

>switch switch
You flipped the switch

>flip switch
You flipped the switch

>look random door
Inscribed on the door is randoor

>randoor
Room
As you enter the next room, the air waftes with the sickening stench of gore, but you don't see any damage. The walls are bleached badly; you can still see the former jarring colors of dark oranges paired with limey greens and violets. The sticky carpet seems like it was once soft. You think that this room may have belonged to a child. You think that you've seen this room before...

You can see a stuffed bear, a photograph and a sailboat here.

>x bear
You see a dilapitated stuffed bear. Its white fluffiness is speckled with deep, reddish brown scabs. Its hollow eyes pierce you. 
You feel its stare boring a hole through your head. You feel its judgement, but no one belittles you and gets away with it. You steel your fists and bash its head in.  Crack. Your bloodied, gnarled hands ache.

>x photo
You see a man surrounded by bookshelves sitting on a desk with mountains of papers--both coffee stained and gold-trimmed. His insiduous grin mocks your incompetence, yet you still feel respect for him. You want his acknowledgment as much as you want to destroy him. Instead, you take pleasure in ripping his image to shreds.

>x sail
You see a sailboat and reminisce on your dreams of escaping this dreary world.

You uncovered a hidden switch and random door!

>x switch
The switch is off

>hit switch
You flipped the switch

>randoor
Room
As you enter the next room, the air waftes with the sickening stench of gore, but you don't see any damage. The walls are bleached badly; you can still see the former jarring colors of dark oranges paired with limey greens and violets. The sticky carpet seems like it was once soft. You think that this room may have belonged to a child. You think that you've seen this room before...

You can see a stuffed bear, photograph and a sailboat here.

>x boat
You see a sailboat and reminisce on your dreams of escaping this dreary world.

>x photo
You can almost taste the sweetly baked loaf of bread that you used to have, captured in this photo. But that taste is no longer yours since you've forsaken the maker of the loaves. You needed a baseline of self respect that was always diminished in her sickly charming ways. But the bread has no part in her machinations, and is left alone.

>x sail
The sailboat sails away on the back of festering dreams

>x bear
You see a dead bear. Its red fluffiness is speckled with deep, brownish white scabs. Its hollow eyes follow you throughout the room
Your eyes are aching; the pain throbs with every step taken away from the bear. It slowly spreads down your face to your fists as your rage builds. You stab the bear in the chest with your damaged fist---you hear something break, but can't feel it. You pummel it again and again until you can feel something. The heart is saved for last.  Crunch. Crunch. Crunch.  Tasty.

You uncovered a hidden switch and random door!

>x switch
The switch is off

>x switch
The switch is off

>flip switch
You flipped the switch

>flip switch
You flipped the switch

>randoor
Room
As you enter the next room, the air waftes with the sickening stench of gore, but you don't see any damage. The walls are bleached badly; you can still see the former jarring colors of dark oranges paired with limey greens and violets. The sticky carpet seems like it was once soft. You think that this room may have belonged to a child. You think that you've seen this room before...

You can see a stuffed bear, photograph and a sailboat here.

>x door
You can't see any such thing.

>x random door
There is nothing here.

>x switch
There is nothing here.

* * *

>x bear
You see a dead bear. As you inch closer to it, the bear's open maw snaps shut. Its hollow eyes pierce you.

You feel its stare boring a hole in your empty chest. You don't need this. Your hands, still wet, reach into the Bear and pull its insides out. The eyes are saved for last.  Crunch. Crunch. Crunch.  Tasty.

>x switch
There is nothing here.

>x photo
A swirl of movement cascades across the picture, like stop motion captured on one still. You love and regret and understand and forgive and still feel anger against fate and the whims of forces you cannot control. The moving body stays silently on the wall, proud in its withering defiance.

* * *

>x photo
You can't bear to look away and you can't live with yourself staring at the photo on the wall.

>x switch
There is nothing here.

* * *

>x boat
You see a sailboat and reminisce on your dreams of escaping this dreary world.

You uncovered a hidden switch and random door!

>x photo
You can't bear to look away and you can't live with yourself staring at the photo on the wall.

>x bear
You hate this bear.

>x switch
The switch is off

>switch switch
You flipped the switch

>randoor
Room
As you enter the next room, the air waftes with the sickening stench of gore, but you don't see any damage. The walls are bleached badly; you can still see the former jarring colors of dark oranges paired with limey greens and violets. The sticky carpet seems like it was once soft. You think that this room may have belonged to a child. You think that you've seen this room before...

You can see a stuffed bear, a photograph and a sailboat here.

>x photo
Scattered shreds of a ruined photograph are stuck to the floor

>x boat
On closer examination, you notice that the sailboat is made up of entirely different pieces. You wonder which piece was the original--or if it's even there at all.

>x switch
The switch is on

>randoor
Room
As you enter the next room, the air waftes with the sickening stench of gore, but you don't see any damage. The walls are bleached badly; you can still see the former jarring colors of dark oranges paired with limey greens and violets. The sticky carpet seems like it was once soft. You think that this room may have belonged to a child. You think that you've seen this room before...

You can see a stuffed bear, photograph and a sailboat here.

>x photo
Your stomach growls as you yearn for the bread.

>x boat
The sailboat sails away on the back of festering dreams

>x switch
The switch is on

* * *

>randoor
Room
As you enter the next room, the air waftes with the sickening stench of gore, but you don't see any damage. The walls are bleached badly; you can still see the former jarring colors of dark oranges paired with limey greens and violets. The sticky carpet seems like it was once soft. You think that this room may have belonged to a child. You think that you've seen this room before...

You can see a stuffed bear, photograph and a sailboat here.

>x boat
On closer examination, you notice that the sailboat has the scars of spending most of its life inside a bottle. You feel yourself rooting for the little boat.

>x photo
Scattered shreds of a ruined photograph are stuck to the floor

>x switch
The switch is off

>randoor
Room
As you enter the next room, the air waftes with the sickening stench of gore, but you don't see any damage. The walls are bleached badly; you can still see the former jarring colors of dark oranges paired with limey greens and violets. The sticky carpet seems like it was once soft. You think that this room may have belonged to a child. You think that you've seen this room before...

You can see a stuffed bear, photograph and a sailboat here.

* * *

>x photo
Your stomach growls as you yearn for the bread.

>x bear
You hate this bear.

>x sail
The sailboat sails away on the back of festering dreams

>x switch
The switch is on

* * *

>randoor
Room
As you enter the next room, the air waftes with the sickening stench of gore, but you don't see any damage. The walls are bleached badly; you can still see the former jarring colors of dark oranges paired with limey greens and violets. The sticky carpet seems like it was once soft. You think that this room may have belonged to a child. You think that you've seen this room before...

You can see a stuffed bear, photograph and a sailboat here.

>x photo
You can't bear to look away and you can't live with yourself staring at the photo on the wall.

>x switch
The switch is on

>x switch
The switch is on

>flip switch
You flipped the switch

* * *

>randoor
Room
As you enter the next room, the air waftes with the sickening stench of gore, but you don't see any damage. The walls are bleached badly; you can still see the former jarring colors of dark oranges paired with limey greens and violets. The sticky carpet seems like it was once soft. You think that this room may have belonged to a child. You think that you've seen this room before...

You can see a stuffed bear, photograph and a sailboat here.

>x photo
Scattered shreds of a ruined photograph are stuck to the floor

* * *

>x photo
Your stomach growls as you yearn for the bread.

>x sail
The sailboat sails away on the back of festering dreams

* * *

>x switch
The switch is on

>hit switch
You flipped the switch

* * *

>flip switch
You flipped the switch

>w
You can't go that way.

>n
You can't go that way.

* * *

>s
You can't go that way.

>e
You can't go that way.

>ask about me
You can't see any such thing.

>say "do you know me?'
(to yourself)
There is no reply.

* * *

>x bear
You can't see any such thing.

>x photo
You can't see any such thing.

* * *

>look bbox
You see a screen labeled B-box with a keyboard next to the scratches. Its keyboard only has the alphabet and the digits 0 - 9. The screen pulsates with "WAITING FOR INPUT".

>input 2 4 4
The screen whirls for a few seconds, then outputs a series of digits. You recognize the output as 2 in base 4 converted to base 4:

>input HELPME 34 1
Incorrect Input

>input O6O 23 30
The screen whirls for a few seconds, then outputs a series of digits. You recognize the output as O6O in base 23 converted to base 30:

>input HELPME 34 2
The screen whirls for a few seconds, then outputs a series of digits. You recognize the output as HELPME in base 34 converted to base 2:

>input HELPME 34 1
Incorrect Input

>type o6goceee 28 31
The screen whirls for a few seconds, then outputs:
     B
     R
     E
     A
     K
     P
     O
     T

>smash pot
Violence isn't the answer to this one.

>break pot
In the dusty, smoked-strewn room, amidst the broken pieces of a once intact thing, lies the pot's useless corpse. Was that really necessary?

>check note
+--------------------------------------+
 | Look for painting; Uifsf jt bo boomf. | 
 |  baiting PantS                                        | 
 |  maKe dOor                                           | 
 +--------------------------------------+

>i
You are carrying nothing.

>make door
An old, oak door materializes before you. You go through the door.

As you enter the next room, you smell blood and taste the gnarling cacaphoney of a broken record. Splashes of dried blood cover the walls; everything in the room is sinking and stained. You see your hands. They are red to your wrists, and you can't remove it. You feel nausceous, and start hyperventilating. You struggle through dark spots and white flashes, eventually renouncing sight altogether. You trip on something squishy. You can't get up, and the squishyness is crawling up your leg. You wish you had your knife. You hate this. You hate this so much. You hate this enough to grab the thing and squeeze and squeeze until it cracks and you throw it against the bloody wall and walk over to it and stomp it to bits. You notice tiny globs emerging from the carcass and oozing towards you. You run back to the old door and open it. 

You can see an anger emotion here.

Room
As you enter the next room, you smell blood and taste the gnarling cacaphoney of a broken record. Splashes of dried blood cover the walls; everything in the room is sinking and stained.

You can see a stuffed bear, a photographs and a sailboat here.

* * *

Room Wodplay or Surrealist project
An Interactive Fiction by Avita, Chris & Steph
Release 1 / Serial number 161016 / Inform 7 build 6M62 (I6/v6.33 lib 6/12N) SD

Room
You are in a room.

>[enter]
Room Wodplay or Surrealist project
An Interactive Fiction by Avita, Chris & Steph
Release 1 / Serial number 161016 / Inform 7 build 6M62 (I6/v6.33 lib 6/12N) SD

Room
You are in a room.

* * *

Room Wodplay or Surrealist project
An Interactive Fiction by Avita, Chris & Steph
Release 1 / Serial number 161016 / Inform 7 build 6M62 (I6/v6.33 lib 6/12N) SD

Room
You are in a room.

I beg your pardon?

I beg your pardon?